WE ./fseles.xpm
SO ./fseles.xpm
EA ./fseles.xpm
NO ./fseles.xpm

F 255,0,255
C 0, 0 , 0


11111111111111111111111
10000000000000000000001
10000000000000001000001
10000000000000000000001      11111111
10000000010000000000001      10000000
1000000000000000000000111111110000001
1000000000000000000000000000000000111
1000000000000000100000111111110011111
10000010000000000000001      10000001
100000000000000000000N1      10000001
11111111111111111111111      11111111

