WE ./fseles.xpm
SO ./fseles.xpm
EA ./fseles.xpm
NO ./fseles.xpm

F 241,250,218
C 38, 80, 115


1111111111111111111111111
1000000000000000010000001
1000000000000000010000001
10E0000000000000010000001
1000000000000010010000001
1111111111100111111111111
1000000000000000010000001
1000000000000000010000001
1000000000000000010000001
1111111110011111111111111
        1001
        1001
        1001
        1001
        1001
11111111100111111111111
10000000000000000000001
10000000000000001000001
10000000000000000000001      11111111
10000000010000000000001      10000001
1000000000000000000000111111110000001
1000000000000000000000000000000000111
1000000000000000100000111111110011111
10000010000000000000001      10000001
10000000000000000000001      10000001
11111111111111111111111      11111111

