WE ./hihi
SO ./test
EA ./hahah
NO ./hello

F 255,0,      255
C 0, 0 , 0


        11111111111111111
1111111110000000000000001
10000000000000001
11111111111111111




