WE ./walls/walls_xpm/WestWall100.xpm
SO ./walls/walls_xpm/SouthWall100.xpm
EA ./walls/walls_xpm/EastWall100.xpm
NO ./walls/walls_xpm/NorthWall100.xpm

F 241, 250, 218
C 38, 80, 15

 1111111
10000N001
 1111111