WE ./walls/walls_xpm/WestWall100.xpm
SO ./walls/walls_xpm/SouthWall100.xpm
EA ./walls/walls_xpm/EastWall100.xpm
NO ./walls/walls_xpm/NorthWall100.xpm

F 241, 250, 218
C 38, 80, 15

111111
1000001
100001N1
1000001
111111