WE ./walls/walls_xpm/WestWall100.xpm
SO ./walls/walls_xpm/SouthWall100.xpm
EA ./walls/walls_xpm/EastWall100.xpm
NO ./walls/walls_xpm/NorthWall100.xpm

F 241,250,218
C 38,80,15


1111111111111111111111111
1000000000000000010000001
1000000000000000010000001
1N00000000000000010000001
110000000000010010000001
1111111111100111111111111
1000000000000000010000001
1000000000000000010000001
10000000000000000100000011
1111111110011111111111111
        1001
        1001
        1001
        1001
        1001
1111111111111111111111111
1000000000000000010000001
1000000000000000010000001
1000000000000000010000001
110000000000010010000001
1111111111100111111111111
1000000000000000010000001
1000000000000000010000001
1000000000000000010000001
1111111110011111111111111
        1001
        1001
        1001
        1001
        1001
1111111111111111111111111
1000000000000000010000001
1000000000000000010000001
1000000000000000010000001
110000000000010010000001
1111111111100111111111111
1000000000000000010000001
1000000000000000010000001
1000000000000000010000001
1111111110011111111111111
        1001
        1001
        1001
        1001
        1111
1111 1111 11 111111 11111111