WE ./fseles.xpm
SO ./fseles.xpm
EA ./fseles.xpm
NO ./fseles.xpm

F 255,0,255
C 0, 0 , 0


11111111111111111111111
10000000000000000000001
10000000000000001000001
10000000000000000000001
10000000010000000000001
10000000000000000000001
10000000000000000000001
10000000000000001000001
10000010000000000000001
100000000000000000000N1
11111111111111111111111

