
line2

NO ./hello

SO ./test
EA ./hahah

11111111111111111
10000000000000001
10000000000000001
11111111111111111